5 12
########-###
#----------#
#-##########
#---------X#
############

