8 13
##-##########
#-----------#
#-----------#
#------------
#-----------#
#------X----#
#-----------#
#############
